############
#         P#
# X## OO   #
#          #
#          #
#      X   #
#####      #
#   X      #
#          #
#     ######
#     X   O#
# O        #
############
