######################
#  #     #O          #
# X#     O#    #     #
#  #     #      #    #
#        #     X     #
####  P  ###### ###  #
#                    #
#  X               O #
#                    #
######################
