###########
#         #
#  P    X #
#         #
#         #
#  OOO X  #
#  OOO    #
#  OOO    #
###########